а	быть	ли	мальчик
а	все-таки	бог	жалко
а	горло	бредить	бритва
а	ларчик	просто	открываться
а	напоследок	я	сказать
а	философ	без	огурцов
абыр	валга	означать	главрыба
альпинистка	мой	скалолазка	мой
анекдот	это	одалживать	юмор
аннушка	уже	разливать	масло
артиллерия	бить	по	свой
архискверный	подражание	архискверный	достоевский
ба	знакомый	все	лицо
бальзак	венчаться	в	бердичев
без	я	народ	неполный
бензин	ваш	идея	наш
блок	трагический	тенор	эпоха
бог	нет	душа	клеточка
бог	нету	химия	все
большой	могучий	русский	язык
болящий	дух	врачевать	песнопение
бояться	данаец	приносить	яйцы
бритва	тупой	изрезаться	скоро
быть	высокий	пожаловать	улыбка
быть	каждый	при	свой
быть	ценность	незыблемый	скала
в	греция	весь	быть
в	какой	полк	служить
в	литература	попереть	читатель
в	минута	жизнь	трудный
в	москва	два	университет
в	небо	запускать	ананас
в	отдаление	реять	квартальный
в	политика	вне	партия
в	поэзия	пора	эстрада
в	тот	баснословный	год
в	тришкин	кафтан	щеголять
в	хороший	дом	филадельфия
в	чин	мы	небольшой
ванька	ключник	злой	разлучник
ваш	благородие	госпожа	разлука
ваш	палец	пахнуть	ладан
введение	единомыслие	в	россия
ведь	предмет	просто	фуфу
великий	бал	у	сатана
великий	конферансье	земля	русский
весна	выставляться	первый	рама
весна	свет	весна	вода
весь	россия	наш	сад
веяние	эпоха	веяние	эпоха
взять	да	и	стушевываться
виват	россия	виват	драгай
видение	первоначальный	чистый	день
владыка	мир	быть	труд
внутренний	эмигрант	внутренний	эмиграция
во	вкус	умный	старина
воскрешать	свое	доживать	хотеть
вот	злонравие	достойный	плод
вот	неделя	другой	проходить
вот	сладкий	плод	учение
вперед	вперед	мой	историй
вперед	ребята	смерть	нет
все	волновать	нежный	ум
все	как	муха	выздоравливать
все	расхищать	предавать	продавать
вставать	подыматься	рабочий	народ
второй	стадия	кража	гусь
вы	жалкий	ничтожный	личность
вы	здесь	не	стоять
вы	из	другой	поколение
вы	мат	товарищ	гроссмейстер
выражаться	сильно	российский	народ
газета	что	изволить	издавать
галантерейный	черт	взять	обхождение
галантерный	половина	человеческий	род
герой	скиталец	море	альбатрос
глотатель	пустота	читатель	газета
глубокоуважаемый	вагоноуважать	вагоноуважаемый	глубокоуважать
голодать	чтоб	они	пировать
гомер	мильтон	и	паниковский
гореть	восток	заря	новый
горький	слово	мой	посмеяться
гость	съезжаться	на	дача
грибной	охота	третий	охота
грясти	спасать	царь	суворов
давать	миллион	давать	миллион
девица	красавица	душенька	подруженька
демьян	бедный	мужик	вредный
день	александров	прекрасный	начало
диалектик	обаятельный	либерал	идеалист
дикий	народ	ребенок	гора
для	бог	мертвый	нет
доказывать	что	ты	гусар
дорогой	мой	хор	роший
драма	рождаться	на	площадь
драпироваться	в	байроновский	плащ
драть	с	трудящийся	втридорога
драть	только	с	проезжать
дрожать	огонь	печальный	деревня
друг	мой	прекрасный	черта
дух	отрицание	дух	сомнение
душа	влечься	в	примитив
душа	мой	элизиум	тень
дыра	бул	щыл	убешщур
дышать	глубоко	вы	взволновать
единица	вздор	единица	ноль
единство	форма	и	содержание
еще	до	исторический	материализм
жизнь	и	поэзия	один
жираф	большой	он	видный
житие	дурак	между	трусы
за	грань	прошлый	день
за	море	житие	нехудо
здесь	все	я	переживать
здравствовать	барыня	сударыня	дворянка
здравствовать	племя	младой	незнакомый
знойный	женщина	мечта	поэт
золото	золото	сердце	народный
и	всюду	меркантильный	дух
и	зло	наскучивать	он
и	козел	на	сакс
и	крестьянка	любить	уметь
и	откупщик	кабачный	гений
и	порастать	трава	забвение
и	разный	прочий	шведов
и	резкий	охлаждать	ум
и	славно	писать	переводить
и	творчество	и	чудотворство
и	тихо	слеза	капать
и	устрица	иметь	враг
идея	попадать	на	улица
из	дальний	странствие	возвратиться
из	любовь	к	искусство
имя	этот	тема	любовь
интересный	начинание	между	прочее
испортить	песня	дура	рак
история	народ	принадлежать	поэт
история	народ	принадлежать	царь
история	прекращать	течение	свой
итак	она	зваться	татьяна
как	белка	в	колесо
как	жить	как	животик
какой	сила	двигать	народ
командовать	парад	быть	я
коммунистический	партия	государственный	безопасность
контора	рог	и	копыто
конфликт	хороший	с	хороший
кофе	ты	быть	какав
край	москва	край	родной
крестьянин	в	закон	мертвый
крой	эрудиция	вопрос	рой
кто	весь	это	мешать
кто	и	кобыла	невеста
кустарь	одиночка	с	мотор
ландыш	лютик	ласка	любовный
литератор	пописывать	читатель	почитывать
лишь	море	черный	шуметь
любить	книга	источник	знание
любить	мечта	мой	создание
любовница	который	вылюблять	ротшильд
любовь	весь	возраст	покорный
любовь	удивление	мгновенный	дань
любовь	это	сон	упоительный
мадам	уже	падать	лист
майский	день	именины	сердце
марш	вперед	труба	звать
матушка	голубушка	солнышко	мой
между	молот	и	наковальня
много	пить	мало	закусывать
мой	милиция	я	беречь
мой	организм	отравлять	алкоголь
молодой	штурман	будущий	буря
молоткастый	серпастый	советский	паспорт
молчалин	блаженствовать	на	свет
муж	в	сражение	изувечивать
муха	как	черный	мысль
мы	вымирать	по	порядок
мы	звезда	кроткий	сиять
мы	ленивый	и	нелюбопытный
мы	на	баба	променивать
мы	ненавистный	тиран	корона
мы	отдыхать	мы	отдыхать
мы	попадать	в	запендю
мы	разучиваться	нищий	подавать
мы	уничтожать	знак	препинание
на	воля	в	пампасы
на	лоно	сельский	тишина
на	лужайка	детский	крик
на	наш	прощальный	ужин
на	поле	брать	тишина
на	тот	война	незнаменитый
на	тризна	грозный	отец
надежда	кроткий	посланница	небо
надо	жить	надо	жить
наука	содружество	человек	разрушать
начальство	иметь	тонкий	вид
начинаться	чин	переставать	искренность
наш	в	город	много
наш	душа	золотой	россыпь
ндрав	мой	не	препятствовать
не	бывать	любовь	несчастливый
не	вытерпеть	зажглось	ретивый
не	обманывать	не	продавать
не	сравнивать	жить	несравнимый
не	читатель	а	писатель
небо	крупный	оптовый	смерть
неслыханный	перемена	невиданный	мятеж
нет	женщина	быть	антимужчина
нет	узы	святой	товарищество
нету	никакой	мой	возможность
низкий	сорт	нечистый	работа
никто	не	обнимать	необъятный
но	божество	мой	проголодаться
ночь	улица	фонарь	аптека
ну	есенин	мужиковствующий	свора
ну	ж	быть	денек
ну	ты	жертва	аборт
нужно	проезживаться	по	россия
о	гений	чистый	красота
облако	неуловимый	волокнистый	стадо
она	быть	мечта	поэт
они	даром	бременить	земля
оробеть	загоревать	курица	обижать
осторожность	осторожность	осторожность	господь
откуда	ты	прекрасный	дитя
откуда	ты	эфир	житель
ох	глухота	большой	порок
охмурять	самый	охмуреж	идти
пава	изображать	умирать	несчастный
пахнуть	сено	над	луг
переводчик	почтовый	лошадь	просвещение
пересказывать	предание	русский	семейство
петербургский	текст	русский	литература
по	какой	случай	шум
повесть	пушкин	гол	как-то
погребальный	контора	милость	просить
под	гнет	власть	роковой
под	суд	под	суд
позволять	вы	выходить	вон
поздравлять	вы	гражданин	соврамша
полный	полный	чудо	природа
пора	пора	рог	трубить
пора	приходить	она	влюбляться
посвящение	и	воспоминание	дрянь
последний	туча	рассевать	буря
пострадать	отделываться	легкий	испуг
поцеловать	у	злодей	ручка
почем	опиум	для	народ
почему	абориген	съедать	кук
поэзия	сильный	рука	хромой
прекрасный	вы	брег	таврида
прелестный	бездна	бездна	восторг
прибегать	к	фигура	умолчание
приидут	день	последний	запустение
простота	необходимый	условие	прекрасный
прошедшее	житие	подлый	черта
прямой	дорога	большой	дорога
прямой	короче	парабола	крутой
пускать	дунька	в	европа
пушкин	в	роль	монумент
раззудеться	плечо	размахиваться	рука
разорять	и	не	потерпеть
разрешаться	от	бремя	драма
рассудок	вопреки	наперекор	стихия
ребенок	живой	цветок	земля
роман	век	бурный	поток
россия	мать	россия	сука
рука	боец	колоть	уставать
рука	всевышний	отечество	спасать
рука	дрожать	от	гнев
с	насмешка	отвечать	жужа
свечной	заводик	в	самара
сегодня	я	в	мерлехлюндия
седовласый	магдалина	мужской	род
сей	птенец	гнездо	петров
сейчас	состояться	вынос	тело
сердце	весь	русь	святой
смиряться	кавказ	идти	ермолов
советский	антисоветский	какой	разница
современный	титан	русский	мысль
соловей	залетный	юность	пролететь
союз	меч	и	орать
спеть	светик	не	стыдиться
сплетня	сеять	сорока	короткохвостый
сплясать	цыганка	жизнь	мой
старинный	человек	мой	отец
стиль	бывать	разный	луев
стих	не	писаться	случаться
сторониться	богач	беднота	гулять
страдание	купить	вечный	гармония
страдать	рыдать	терпеть	исчезать
странный	вещь	непонятный	вещь
строгость	строгость	и	строгость
струна	звенеть	в	туман
счастливый	час	не	наблюдать
съезжалися	к	загс	трамвай
сын	больной	больной	век
сын	твой	любимец	слава
сыскать	начало	все	начинать
сюжет	для	небольшой	рассказ
сюжет	достойный	кисть	айвазовский
так	быть	так	быть
так	идти	державный	шаг
так	начинать	жить	стих
такси	свободный	просить	садиться
тащить	и	не	пущать
твой	мой	не	понимать
тень	знать	свое	место
товарищ	ученый	эйнштейн	драгоценный
только	грядущее	область	поэт
только	синь	сосать	глаз
тоска	по	мировой	культура
транс	цена	ден	тальное
труд	и	творчество	закон
трусоватый	быть	ваня	бедный
трусость	самый	тяжкий	порок
тучка	небесный	вечный	странник
тяжело	умирать	хорошо	умирать
у	все	жена	уходить
у	я	заводиться	ангеленок
ужасный	век	ужасный	сердце
ужель	тот	самый	татьяна
укор	невежда	укор	человек
улица	мой	дома	мой
умеренность	быть	хороший	пир
унтер-офицерша	сам	себя	высекать
урал	опорный	край	держава
услужливый	дурак	опасно	враг
утро	деньги	вечер	стул
уют	нет	покой	нет
факт	не	иметь	прецедент
хлеб	живой	бумага	живой
хозяин	тот	кто	трудиться
холоп	примерный	яков	верный
хранить	я	мой	талисман
царь	испугаться	издавать	манифест
чело	как	череп	голый
человек	в	кожаный	куртка
человек	с	большой	буква
чепуха	белиберда	сапог	всмятку
четвертый	сон	вера	павловна
чистый	прелесть	чистый	образец
читать	дерево	стих	гезиод
чтение	вот	хороший	учение
что	дремучий	лес	призадумываться
что	имя	звук	пустой
что	мой	нога	хотеть
что	слеза	женский	вода
что	ты	надобно	старко
чудо	тайна	и	авторитет
чудо	юдо	рыба	кит
шагнуть	и	царство	покорять
шахматный	клуб	четыре	конь
шутка	с	желчь	пополам
это	весь	француз	гадить
это	не	царский	наука
это	факт	ваш	биография
я	быть	умненький	благоразумненький
я	женщина	слабый	беззащитный
я	из	повиновение	выходить
я	последний	поэт	деревня
я	слушать	и	заслушиваться
я	хотеть	умирать	молодой
я	чайник	заваривать	я
я	человек	измучивать	нарзан
я	числиться	по	россия