поэт	всегда	правый
еще	не	вечер
хозяйка	медный	гора
материально	телесный	низ
битие	определять	сознание
цк	играть	человек
человек	чело	век
шагать	через	мы
мы	за	смех
закат	в	кровь
так	жить	поэт
зачинаться	русский	бред
истекать	клюквенный	сок
век	девятнадцатый	железный
быть	еще	океан
веселый	имя	пушкин
мы	не	тенор
тут	конец	перспектива
эстетика	мать	этика
ниоткуда	с	любовь
волшебный	коробочка	сцена
осетрина	второй	свежесть
подумать	бином	ньютон
рукопись	не	гореть
в	бананово-лимонный	сингапур
возвращаться	плохой	примета
продолжать	наш	игра
где	деньги	зина
нет	ребяты	демократ
четыре	четверть	путь
страшно	аж	жуть
укалываться	и	забываться
здравствовать	дедушка	крылов
бунт	на	колено
ничто	ничего	молчание
отыскиваться	след	тарасов
один	значительный	лицо
ах	какой	пассаж
какой	репримант	неожиданный
господин	средний	рука
попользоваться	насчет	клубничка
пойти	писать	губерния
это	какой-то	обломовщина
великий	бабушка	россия
карьера	и	фортуна
человек	выше	сытость
писатель	который	зазнаваться
чудак	украшать	мир
гореть	сердце	данко
жизнь	быть	деяние
учиться	у	классик
монашеский	известный	поведение
вы	нынешний	нутка
нестор	негодяй	знатный
деревня	лето	рай
все	врать	календарь
французик	из	бордо
пушкин	наш	все
муза	дальний	странствие
день	открытый	убийство
от	живот	веер
цель	поэзия	поэзия
освенцим	без	печь
властитель	и	судья
великолепный	князь	таврида
потомство	грозный	судия
шекснинск	стерлядь	золотой
шампанское	вафля	запивать
заголяться	и	обнажаться
клейкий	весенний	листочек
всякий	сознание	болезнь
усиленно	сознавать	мышь
красота	спасать	мир
старый	камень	европа
убивать	по	теория
искусство	всегда	современный
раскол	в	нигилист
и	немедленно	выпивать
коктейль	слеза	комсомолка
брат	по	разум
аристократически	салонный	поэзия
любить	живопись	поэт
новатор	до	вержболов
край	непуганый	идиот
овес	нынче	дорога
борец	за	идея
заграница	мы	помогать
статистика	знать	весь
словарь	людоедка	эллочка
междупланетный	шахматный	конгресс
плодотворный	дебютный	идея
мусик	готовый	гусик
головотяпство	со	взлом
пешеход	надо	любить
сын	лейтенант	шмидт
сладкий	бремя	слава
инда	взопреть	озимые
бриан	это	голова
пилить	шура	пилить
нежный	и	удивительный
потный	вал	вдохновение
согласно	закон	гостеприимство
сбываться	мечта	идиот
наваливаться	класс	гегемон
хотеться	перехотаться	перетерпеться
земшарная	республика	совет
слово	как	таковой
прощай	хозяйский	горшок
полаять	да	отставать
разлука	уносить	любовь
слава	святой	труд
слушаться	и	повиноваться
принцип	партийность	литература
талант	надо	поощрять
очень	своевременный	книга
книга	огромный	сила
сопряжение	далековатый	идея
молчать	проклятый	струна
наборщик	готовый	смысл
вода	благоволить	литься
капитал	его	препохабие
смерть	не	сметь
самый	человечный	человек
оружие	любимый	род
мастерский	человечий	воскрешение
сделать	мы	красиво
надо	бы	доругаться
поэт	для	производитель
внимать	ужас	война
вырастать	саша	узнавать
продавать	товар	купец
посмотреть	рубль	подарить
собака	собачий	смерть
женщина	ваш	величество
спать	орел	боевой
услышать	будущее	зов
всесильный	бог	деталь
усердие	все	превозмогать
змея	сердечный	угрызение
прощай	свободный	стихия
кавказ	подо	я
длань	народный	немезида
октябрь	уж	наступать
завет	грядущий	вестник
жало	мудрый	змея
любезный	баловень	природа
я	скучный	бес
невольник	честь	беспощадный
приют	убогий	чухонец
дурачина	ты	простофиля
волшебный	сила	песнопение
младой	кровь	играть
романов	отечество	надежда
сцена	у	фонтан
привычка	душа	держава
судьба	евгения	хранить
наука	страсть	нежный
душа	ждать	кто-нибудь
обман	неопытный	душа
онегин	жить	анахорет
лепаж	ствол	роковой
тройка	семерка	туз
бывать	странный	сближение
школа	гармонический	точность
роман	требовать	болтовня
друг	мой	книга
россия	убивать	литература
не	помнить	родство
седьмой	великий	держава
жандарм	утирать	слеза
клуб	взволнованный	лоботряс
занятый	сказать	умирать
я	зарастать	память
кавычка	для	идиот
таратин	таратина	tan
информация	к	размышление
весь	смерть	назло
саша	с	уралмаш
политработа	трудный	работа
благодарить	не	ожидать
изолировать	но	сохранять
кто	организовывать	вставание
революционный	орден	интеллигенция
суета	вокруг	диван
человек	желать	странный
о	приятный	приятство
муза	не	молчать
маг	и	волшебник
писать	не	гулять
дубина	народный	война
курица	выпускать	некуда
непротивление	зло	насилие
литературный	попутчик	революция
насчет	федор	распоряжаться
эмансипе	передовой	женщина
этакий	богатый	тело
для	ради	важность
противоположный	общий	место
несбыточный	грезиться	опять
там	человек	сгорать
веревка	вещь	какой
веревка	вервие	простой
бобэоби	петься	губа
председатель	земной	шар
изобретатель	и	приобретатель
внутренний	склонение	слово
жертва	сапог	всмятку
соль	соль	земля
прекрасный	быть	жизнь
мисюсь	где	ты
монтигомо	ястребиный	коготь
двадцать	два	несчастие
дорогой	многоуважаемый	шкаф
давать	я	атмосфера
россия	страна	казенный
краткость	сестра	талант
таракан	таракан	тараканище
крибла	крабль	бумс
прием	остранение	остраннение
и	огнедышащий	слово
поехать	красотка	кататься
дубинка	петр	великий
искусствовед	в	штатское
мы	не	раб
наш	брат	исаакий
печальник	горе	народный
сапог	выше	шекспир
сопли	и	вопль
фантастика	ближний	прицел